111111111111111111111111111111111
100000000000000000000000000000001
100000000000000000000000000000001
100000100000000000000000000000001
100000100000000000000000000000001
100000000000000000010000000000001
100000000000000000000000000000001
100000100000000000000000000000001
10000000000000x000000000000000001
100000100000000000000000000000001
100000100000000000000000000000001
100000000000000100000000000000001
100000100000000000000000000000001
100000100000000000000000000000001
100000000000000000000000000000001
100000100000000000000000000000001
100000100000000000000000000000001
111111111111111111111111111111111