11111111
10010001
100000x1
10000001
10000001
10010001
10000001
10000001
11111111