111111111111111111111111111111111111111111
100100000000000000000000000000000000000001
100000000000000000000000000000000000000001
10000000000000000x000000000000000000000001
100000000000000000000000000000000000000001
100100000000000000000000000000000000000001
100000000000000000000000000000000000000001
100000000000000000000000000000000000000001
111111111111111111111111111111111111111111