11111111
10000001
10000001
10000001
10x00001
10011001
10011001
10000001
11111111