111111111111111111111111111111111111111111
100100000000000000000000000000000000000001
100000000000000000000000011110000000000001
100000000000x00000000000000000011000000001
100000000000000000000000000000011000000001
100100000000000000001100000000000000000001
100000000000000000001100000000000000000001
100000000000000000000000000000000000000001
111111111111111111111111111111111111111111